ii00000000a00000000000000000ii
ii00100000000000000000000000ii
ii00000000000000000000000000ii
ii00000000000000000000000000ii
----------------------000000ii
000000000000000000000i000000ii
000000000000000000000i000000ii
000000000000000000000i0000--ii
000000000000000000000i000000ii
000000000000000000000i000000ii
000000000000a00000000i000000ii
000000000000i--000000i--0000ii
000000000000i00000000i000000ii
000000000000i000000--i000000ii
--------0000i00000000a000000ii
000000000000i000000000000000ii
000000000000i--0000000000000ii
000000000000i0000000000000--ii
000000000000i00000------0000ii
000000000000i000000000000000ii