000000000000000000000000000000
000000000000000000000000000000
000C00000000000000000000000000
000000000000000000000000000000
000000000000000000000000000000
00------0000-------000--------
000000000000000000000000000000
000000000000000000000000000000
0000000--0000000000000--000000
000000000000000000000000000000
0000000-0000000c0000000-000000
000000000000000000000000000000
-----00-00000000000000--------
000000000000000000000000000001
00000000---0000000000000000000
000000000000000000000000000---
000000000000000000000000000000
--------0000000000000000000000
000000000000000000000000000000
000000000000000000000000000000