aaaaaaaaaaaaaaaaaaaaaaaaaaaaaa
i0000000000000000000000000000i
i0000000000000000000000000000i
i0000-00000000000000000000000i
i00000000-0000---000000000000i
i0G00000000000ia00----0000000i
i---0000000000i000000000----0i
i00000000000--i00000000000000i
i0000000000000i000000g0000000i
i000-----------a-0000---00000i
i00000000000000i000000000----i
ik0000000000000i00--000000000i
i-0000000000000i0000000000000i
0000000000---00i0000000000000i
000000000000000i-----00-00---i
00000---0000000i0000000000000i
000000000000000i00000000000000
-a00000000000--i0000---0000100
ii00g00000000i0i00000000000000
------------------------------