--------00000000i0000000000000
0000000000000000i0000000000000
0000000000g00000i0000000000000
------------0000i00---0-000000
--------00000000i0000i0-000000
--------0000000-i00i0i0-000000
0000000000000000i00i0i0-000000
0000000000000000i00i0i0-000000
000000000l000---i00i0i0-000000
000000g00---0000i00i0i0-000000
00000---00000000i00i0i0-000000
0G00000000000000i00i0i0-000000
---0000000000000i00i0i0-000000
0000000000000000i00i0i0-000000
00000---00000000i00i0i0-000000
0000000000000000a00i0i0-000000
0k00000000000000000i0i0-000100
---00000G0000000000i0i0-000000
0000000---000000000i0i--------
000000000000-------00000000000