000000000000i00000000000000000
000000000000i00000000000000000
000000000000i00000000000000000
000g00000000i00000000000000000
-------a0000i0K0000g0000000000
0000000i00--i--------------00-
0000000i0000i0000000000000000-
0000000il000i0000000000000000-
0000000i--00i0000000000000000-
0000000i0000i0000000000000000-
aaaaaaai0000i0000000000000000-
0000000000--i0000000000000000-
000000000000i0000000000000000-
000000000000iaa00000000000000-
------------------a00a--------
-000000000000000aaa00i00000000
-00000000000000000000i00000000
-00000000000000000000i--000010
-0k0G000000000000g000i----a000
------------------------------