000000000000000000000000000000
000000000000000000000000000000
000000000000000000000000000000
000000000000000000000000000000
000000000000000000000000000000
000000000000000000000000000000
000000000000000000000000000000
000000000000000000000000000000
000000000000000000000000000000
000000000000000000000000000000
000000000000000000000000000000
000000000000000000000000000000
000000000000000000000000000000
00000000000a0000000a0000000000
00000000000a0000000a0000000000
00000000000000000-----000aaa00
000000000000000000000000100000
000------------000000000000000
000000000000000000000000000000
------------------------------