------------------------------
i0000000000000000000000000000i
i0000000000000000000000000000i
i0000000000000000000000000000i
i0000000000000000000a000000--i
i0001000---000--------00-0000i
i00---00000000000000000000000i
i0000000000000000000000000000i
i000000-00000000000000--00000i
i000000000000000a000000000000i
i00000000--000------000000---i
i-----0000000000000--00000000i
i0000000000000000000000-00000i
i0000000-00000000000000000---i
i00--00000000a000000--0000000i
i00000000000--000000000020000i
i00000--0000000000-0000---000i
ii000000000000a00000000000000i
i0000000000000i00000000000000i
------------------------------